OBJECTID,DATA_RICEVIMENTO_TAMPONE,NUM_TAMP,INCREMENTO,REGIONE,ObjectId2
1,20200220,3,3,LOMBARDIA,1
2,20200221,30,33,LOMBARDIA,2
3,20200222,32,65,LOMBARDIA,3
4,20200223,47,112,LOMBARDIA,4
5,20200224,60,172,LOMBARDIA,5
6,20200225,96,268,LOMBARDIA,6
7,20200226,117,385,LOMBARDIA,7
8,20200227,147,532,LOMBARDIA,8
9,20200228,204,736,LOMBARDIA,9
10,20200229,250,986,LOMBARDIA,10
11,20200301,284,1270,LOMBARDIA,11
12,20200302,397,1667,LOMBARDIA,12
13,20200303,477,2144,LOMBARDIA,13
14,20200304,630,2774,LOMBARDIA,14
15,20200305,793,3567,LOMBARDIA,15
16,20200306,904,4471,LOMBARDIA,16
17,20200307,701,5172,LOMBARDIA,17
18,20200308,772,5944,LOMBARDIA,18
19,20200309,1216,7160,LOMBARDIA,19
20,20200310,1353,8513,LOMBARDIA,20
21,20200311,1335,9848,LOMBARDIA,21
22,20200312,1362,11210,LOMBARDIA,22
23,20200313,1723,12933,LOMBARDIA,23
24,20200314,1375,14308,LOMBARDIA,24
25,20200315,1194,15502,LOMBARDIA,25
26,20200316,2134,17636,LOMBARDIA,26
27,20200317,2087,19723,LOMBARDIA,27
28,20200318,2161,21884,LOMBARDIA,28
29,20200319,2231,24115,LOMBARDIA,29
30,20200320,2225,26340,LOMBARDIA,30
31,20200321,1410,27750,LOMBARDIA,31
32,20200322,1163,28913,LOMBARDIA,32
33,20200323,2191,31104,LOMBARDIA,33
34,20200324,2159,33263,LOMBARDIA,34
35,20200325,2053,35316,LOMBARDIA,35
36,20200326,2054,37370,LOMBARDIA,36
37,20200327,1993,39363,LOMBARDIA,37
38,20200328,1364,40727,LOMBARDIA,38
39,20200329,758,41485,LOMBARDIA,39
40,20200330,1760,43245,LOMBARDIA,40
41,20200331,1542,44787,LOMBARDIA,41
42,20200401,1812,46599,LOMBARDIA,42
43,20200402,1625,48224,LOMBARDIA,43
44,20200403,1618,49842,LOMBARDIA,44
45,20200404,1081,50923,LOMBARDIA,45
46,20200405,640,51563,LOMBARDIA,46
47,20200406,1569,53132,LOMBARDIA,47
48,20200407,1490,54622,LOMBARDIA,48
49,20200408,1501,56123,LOMBARDIA,49
50,20200409,1929,58052,LOMBARDIA,50
51,20200410,2051,60103,LOMBARDIA,51
52,20200411,1136,61239,LOMBARDIA,52
53,20200412,553,61792,LOMBARDIA,53
54,20200413,568,62360,LOMBARDIA,54
55,20200414,1151,63511,LOMBARDIA,55
56,20200415,1382,64893,LOMBARDIA,56
57,20200416,1254,66147,LOMBARDIA,57
58,20200417,1308,67455,LOMBARDIA,58
59,20200418,757,68212,LOMBARDIA,59
60,20200419,392,68604,LOMBARDIA,60
61,20200420,1160,69764,LOMBARDIA,61
62,20200421,1074,70838,LOMBARDIA,62
63,20200422,968,71806,LOMBARDIA,63
64,20200423,1210,73016,LOMBARDIA,64
65,20200424,1023,74039,LOMBARDIA,65
66,20200425,496,74535,LOMBARDIA,66
67,20200426,228,74763,LOMBARDIA,67
68,20200427,925,75688,LOMBARDIA,68
69,20200428,869,76557,LOMBARDIA,69
70,20200429,1049,77606,LOMBARDIA,70
71,20200430,1034,78640,LOMBARDIA,71
72,20200501,259,78899,LOMBARDIA,72
73,20200502,289,79188,LOMBARDIA,73
74,20200503,115,79303,LOMBARDIA,74
75,20200504,709,80012,LOMBARDIA,75
76,20200505,764,80776,LOMBARDIA,76
77,20200506,716,81492,LOMBARDIA,77
78,20200507,688,82180,LOMBARDIA,78
79,20200508,664,82844,LOMBARDIA,79
80,20200509,248,83092,LOMBARDIA,80
81,20200510,89,83181,LOMBARDIA,81
82,20200511,473,83654,LOMBARDIA,82
83,20200512,430,84084,LOMBARDIA,83
84,20200513,418,84502,LOMBARDIA,84
85,20200514,396,84898,LOMBARDIA,85
86,20200515,361,85259,LOMBARDIA,86
87,20200516,299,85558,LOMBARDIA,87
88,20200517,87,85645,LOMBARDIA,88
89,20200518,321,85966,LOMBARDIA,89
90,20200519,363,86329,LOMBARDIA,90
91,20200520,373,86702,LOMBARDIA,91
92,20200521,350,87052,LOMBARDIA,92
93,20200522,437,87489,LOMBARDIA,93
94,20200523,167,87656,LOMBARDIA,94
95,20200524,63,87719,LOMBARDIA,95
96,20200525,289,88008,LOMBARDIA,96
97,20200526,321,88329,LOMBARDIA,97
98,20200527,350,88679,LOMBARDIA,98
99,20200528,317,88996,LOMBARDIA,99
100,20200529,222,89218,LOMBARDIA,100
101,20200530,172,89390,LOMBARDIA,101
102,20200531,26,89416,LOMBARDIA,102
103,20200601,246,89662,LOMBARDIA,103
104,20200602,31,89693,LOMBARDIA,104
157,20200725,40,95910,LOMBARDIA,105
158,20200726,15,95925,LOMBARDIA,106
159,20200727,80,96005,LOMBARDIA,107
160,20200728,68,96073,LOMBARDIA,108
161,20200729,84,96157,LOMBARDIA,109
162,20200730,51,96208,LOMBARDIA,110
163,20200731,61,96269,LOMBARDIA,111
164,20200801,34,96303,LOMBARDIA,112
165,20200802,17,96320,LOMBARDIA,113
166,20200803,172,96492,LOMBARDIA,114
167,20200804,76,96568,LOMBARDIA,115
168,20200805,83,96651,LOMBARDIA,116
169,20200806,85,96736,LOMBARDIA,117
170,20200807,81,96817,LOMBARDIA,118
171,20200808,59,96876,LOMBARDIA,119
172,20200809,21,96897,LOMBARDIA,120
173,20200810,99,96996,LOMBARDIA,121
174,20200811,96,97092,LOMBARDIA,122
175,20200812,94,97186,LOMBARDIA,123
176,20200813,98,97284,LOMBARDIA,124
177,20200814,105,97389,LOMBARDIA,125
178,20200815,18,97407,LOMBARDIA,126
179,20200816,20,97427,LOMBARDIA,127
180,20200817,147,97574,LOMBARDIA,128
181,20200818,150,97724,LOMBARDIA,129
182,20200819,170,97894,LOMBARDIA,130
183,20200820,207,98101,LOMBARDIA,131
184,20200821,276,98377,LOMBARDIA,132
185,20200822,155,98532,LOMBARDIA,133
186,20200823,52,98584,LOMBARDIA,134
187,20200824,339,98923,LOMBARDIA,135
188,20200825,346,99269,LOMBARDIA,136
189,20200826,295,99564,LOMBARDIA,137
190,20200827,360,99924,LOMBARDIA,138
191,20200828,263,100187,LOMBARDIA,139
192,20200829,168,100355,LOMBARDIA,140
193,20200830,83,100438,LOMBARDIA,141
194,20200831,331,100769,LOMBARDIA,142
195,20200901,290,101059,LOMBARDIA,143
196,20200902,343,101402,LOMBARDIA,144
197,20200903,294,101696,LOMBARDIA,145
198,20200904,300,101996,LOMBARDIA,146
199,20200905,153,102149,LOMBARDIA,147
200,20200906,63,102212,LOMBARDIA,148
201,20200907,275,102487,LOMBARDIA,149
202,20200908,246,102733,LOMBARDIA,150
203,20200909,255,102988,LOMBARDIA,151
204,20200910,242,103230,LOMBARDIA,152
205,20200911,226,103456,LOMBARDIA,153
206,20200912,126,103582,LOMBARDIA,154
207,20200913,39,103621,LOMBARDIA,155
208,20200914,19,103640,LOMBARDIA,156
105,20200603,252,89945,LOMBARDIA,157
106,20200604,248,90193,LOMBARDIA,158
107,20200605,254,90447,LOMBARDIA,159
108,20200606,120,90567,LOMBARDIA,160
109,20200607,35,90602,LOMBARDIA,161
110,20200608,173,90775,LOMBARDIA,162
111,20200609,248,91023,LOMBARDIA,163
112,20200610,241,91264,LOMBARDIA,164
113,20200611,324,91588,LOMBARDIA,165
114,20200612,280,91868,LOMBARDIA,166
115,20200613,124,91992,LOMBARDIA,167
116,20200614,40,92032,LOMBARDIA,168
117,20200615,196,92228,LOMBARDIA,169
118,20200616,169,92397,LOMBARDIA,170
119,20200617,204,92601,LOMBARDIA,171
120,20200618,137,92738,LOMBARDIA,172
121,20200619,188,92926,LOMBARDIA,173
122,20200620,60,92986,LOMBARDIA,174
123,20200621,12,92998,LOMBARDIA,175
124,20200622,170,93168,LOMBARDIA,176
125,20200623,149,93317,LOMBARDIA,177
126,20200624,117,93434,LOMBARDIA,178
127,20200625,101,93535,LOMBARDIA,179
128,20200626,107,93642,LOMBARDIA,180
129,20200627,45,93687,LOMBARDIA,181
130,20200628,29,93716,LOMBARDIA,182
131,20200629,136,93852,LOMBARDIA,183
132,20200630,99,93951,LOMBARDIA,184
133,20200701,125,94076,LOMBARDIA,185
134,20200702,130,94206,LOMBARDIA,186
135,20200703,108,94314,LOMBARDIA,187
136,20200704,102,94416,LOMBARDIA,188
137,20200705,22,94438,LOMBARDIA,189
138,20200706,130,94568,LOMBARDIA,190
139,20200707,94,94662,LOMBARDIA,191
140,20200708,120,94782,LOMBARDIA,192
141,20200709,100,94882,LOMBARDIA,193
142,20200710,107,94989,LOMBARDIA,194
143,20200711,59,95048,LOMBARDIA,195
144,20200712,11,95059,LOMBARDIA,196
145,20200713,63,95122,LOMBARDIA,197
146,20200714,78,95200,LOMBARDIA,198
147,20200715,77,95277,LOMBARDIA,199
148,20200716,66,95343,LOMBARDIA,200
149,20200717,85,95428,LOMBARDIA,201
150,20200718,49,95477,LOMBARDIA,202
151,20200719,15,95492,LOMBARDIA,203
152,20200720,72,95564,LOMBARDIA,204
153,20200721,69,95633,LOMBARDIA,205
154,20200722,61,95694,LOMBARDIA,206
155,20200723,91,95785,LOMBARDIA,207
156,20200724,85,95870,LOMBARDIA,208
