OBJECTID,DATA_RICEVIMENTO_TAMPONE,NUM_TAMP,INCREMENTO,REGIONE,ObjectId2
1,20200220,3,3,LOMBARDIA,1
2,20200221,30,33,LOMBARDIA,2
3,20200222,32,65,LOMBARDIA,3
4,20200223,47,112,LOMBARDIA,4
5,20200224,60,172,LOMBARDIA,5
6,20200225,96,268,LOMBARDIA,6
7,20200226,117,385,LOMBARDIA,7
8,20200227,147,532,LOMBARDIA,8
9,20200228,204,736,LOMBARDIA,9
10,20200229,250,986,LOMBARDIA,10
11,20200301,284,1270,LOMBARDIA,11
12,20200302,396,1666,LOMBARDIA,12
13,20200303,477,2143,LOMBARDIA,13
14,20200304,629,2772,LOMBARDIA,14
15,20200305,791,3563,LOMBARDIA,15
16,20200306,904,4467,LOMBARDIA,16
17,20200307,701,5168,LOMBARDIA,17
18,20200308,771,5939,LOMBARDIA,18
19,20200309,1215,7154,LOMBARDIA,19
20,20200310,1353,8507,LOMBARDIA,20
21,20200311,1335,9842,LOMBARDIA,21
22,20200312,1362,11204,LOMBARDIA,22
23,20200313,1721,12925,LOMBARDIA,23
24,20200314,1374,14299,LOMBARDIA,24
25,20200315,1194,15493,LOMBARDIA,25
26,20200316,2133,17626,LOMBARDIA,26
27,20200317,2087,19713,LOMBARDIA,27
28,20200318,2161,21874,LOMBARDIA,28
29,20200319,2231,24105,LOMBARDIA,29
30,20200320,2225,26330,LOMBARDIA,30
31,20200321,1410,27740,LOMBARDIA,31
32,20200322,1163,28903,LOMBARDIA,32
33,20200323,2191,31094,LOMBARDIA,33
34,20200324,2158,33252,LOMBARDIA,34
35,20200325,2053,35305,LOMBARDIA,35
36,20200326,2054,37359,LOMBARDIA,36
37,20200327,1993,39352,LOMBARDIA,37
38,20200328,1364,40716,LOMBARDIA,38
39,20200329,758,41474,LOMBARDIA,39
40,20200330,1760,43234,LOMBARDIA,40
41,20200331,1542,44776,LOMBARDIA,41
42,20200401,1812,46588,LOMBARDIA,42
43,20200402,1625,48213,LOMBARDIA,43
44,20200403,1618,49831,LOMBARDIA,44
45,20200404,1081,50912,LOMBARDIA,45
46,20200405,640,51552,LOMBARDIA,46
47,20200406,1569,53121,LOMBARDIA,47
48,20200407,1490,54611,LOMBARDIA,48
49,20200408,1501,56112,LOMBARDIA,49
50,20200409,1929,58041,LOMBARDIA,50
51,20200410,2051,60092,LOMBARDIA,51
52,20200411,1136,61228,LOMBARDIA,52
53,20200412,553,61781,LOMBARDIA,53
107,20200605,254,90436,LOMBARDIA,54
108,20200606,120,90556,LOMBARDIA,55
109,20200607,35,90591,LOMBARDIA,56
110,20200608,173,90764,LOMBARDIA,57
111,20200609,248,91012,LOMBARDIA,58
112,20200610,241,91253,LOMBARDIA,59
113,20200611,324,91577,LOMBARDIA,60
114,20200612,280,91857,LOMBARDIA,61
115,20200613,124,91981,LOMBARDIA,62
116,20200614,40,92021,LOMBARDIA,63
117,20200615,196,92217,LOMBARDIA,64
118,20200616,169,92386,LOMBARDIA,65
119,20200617,204,92590,LOMBARDIA,66
120,20200618,137,92727,LOMBARDIA,67
121,20200619,188,92915,LOMBARDIA,68
122,20200620,60,92975,LOMBARDIA,69
123,20200621,12,92987,LOMBARDIA,70
124,20200622,170,93157,LOMBARDIA,71
125,20200623,149,93306,LOMBARDIA,72
126,20200624,117,93423,LOMBARDIA,73
127,20200625,101,93524,LOMBARDIA,74
128,20200626,107,93631,LOMBARDIA,75
129,20200627,45,93676,LOMBARDIA,76
130,20200628,29,93705,LOMBARDIA,77
131,20200629,136,93841,LOMBARDIA,78
132,20200630,99,93940,LOMBARDIA,79
133,20200701,125,94065,LOMBARDIA,80
134,20200702,130,94195,LOMBARDIA,81
135,20200703,108,94303,LOMBARDIA,82
136,20200704,102,94405,LOMBARDIA,83
137,20200705,22,94427,LOMBARDIA,84
138,20200706,130,94557,LOMBARDIA,85
139,20200707,94,94651,LOMBARDIA,86
140,20200708,120,94771,LOMBARDIA,87
141,20200709,100,94871,LOMBARDIA,88
142,20200710,107,94978,LOMBARDIA,89
143,20200711,59,95037,LOMBARDIA,90
144,20200712,11,95048,LOMBARDIA,91
145,20200713,63,95111,LOMBARDIA,92
146,20200714,78,95189,LOMBARDIA,93
147,20200715,77,95266,LOMBARDIA,94
148,20200716,66,95332,LOMBARDIA,95
149,20200717,85,95417,LOMBARDIA,96
150,20200718,49,95466,LOMBARDIA,97
151,20200719,15,95481,LOMBARDIA,98
152,20200720,72,95553,LOMBARDIA,99
153,20200721,69,95622,LOMBARDIA,100
154,20200722,61,95683,LOMBARDIA,101
155,20200723,91,95774,LOMBARDIA,102
156,20200724,85,95859,LOMBARDIA,103
157,20200725,40,95899,LOMBARDIA,104
158,20200726,15,95914,LOMBARDIA,105
159,20200727,80,95994,LOMBARDIA,106
160,20200728,68,96062,LOMBARDIA,107
161,20200729,84,96146,LOMBARDIA,108
162,20200730,51,96197,LOMBARDIA,109
163,20200731,61,96258,LOMBARDIA,110
164,20200801,34,96292,LOMBARDIA,111
165,20200802,17,96309,LOMBARDIA,112
166,20200803,172,96481,LOMBARDIA,113
167,20200804,76,96557,LOMBARDIA,114
168,20200805,83,96640,LOMBARDIA,115
169,20200806,84,96724,LOMBARDIA,116
170,20200807,81,96805,LOMBARDIA,117
171,20200808,59,96864,LOMBARDIA,118
172,20200809,21,96885,LOMBARDIA,119
173,20200810,99,96984,LOMBARDIA,120
174,20200811,96,97080,LOMBARDIA,121
175,20200812,95,97175,LOMBARDIA,122
176,20200813,98,97273,LOMBARDIA,123
177,20200814,105,97378,LOMBARDIA,124
178,20200815,18,97396,LOMBARDIA,125
179,20200816,20,97416,LOMBARDIA,126
180,20200817,147,97563,LOMBARDIA,127
181,20200818,150,97713,LOMBARDIA,128
182,20200819,170,97883,LOMBARDIA,129
183,20200820,207,98090,LOMBARDIA,130
184,20200821,276,98366,LOMBARDIA,131
185,20200822,155,98521,LOMBARDIA,132
186,20200823,52,98573,LOMBARDIA,133
187,20200824,337,98910,LOMBARDIA,134
188,20200825,345,99255,LOMBARDIA,135
189,20200826,295,99550,LOMBARDIA,136
190,20200827,358,99908,LOMBARDIA,137
191,20200828,263,100171,LOMBARDIA,138
192,20200829,165,100336,LOMBARDIA,139
193,20200830,84,100420,LOMBARDIA,140
194,20200831,325,100745,LOMBARDIA,141
195,20200901,290,101035,LOMBARDIA,142
196,20200902,340,101375,LOMBARDIA,143
197,20200903,294,101669,LOMBARDIA,144
198,20200904,298,101967,LOMBARDIA,145
199,20200905,151,102118,LOMBARDIA,146
200,20200906,64,102182,LOMBARDIA,147
201,20200907,274,102456,LOMBARDIA,148
202,20200908,242,102698,LOMBARDIA,149
203,20200909,256,102954,LOMBARDIA,150
204,20200910,246,103200,LOMBARDIA,151
205,20200911,241,103441,LOMBARDIA,152
206,20200912,138,103579,LOMBARDIA,153
207,20200913,53,103632,LOMBARDIA,154
208,20200914,217,103849,LOMBARDIA,155
209,20200915,212,104061,LOMBARDIA,156
210,20200916,155,104216,LOMBARDIA,157
211,20200917,88,104304,LOMBARDIA,158
54,20200413,568,62349,LOMBARDIA,159
55,20200414,1151,63500,LOMBARDIA,160
56,20200415,1382,64882,LOMBARDIA,161
57,20200416,1254,66136,LOMBARDIA,162
58,20200417,1308,67444,LOMBARDIA,163
59,20200418,757,68201,LOMBARDIA,164
60,20200419,392,68593,LOMBARDIA,165
61,20200420,1160,69753,LOMBARDIA,166
62,20200421,1074,70827,LOMBARDIA,167
63,20200422,968,71795,LOMBARDIA,168
64,20200423,1210,73005,LOMBARDIA,169
65,20200424,1023,74028,LOMBARDIA,170
66,20200425,496,74524,LOMBARDIA,171
67,20200426,228,74752,LOMBARDIA,172
68,20200427,925,75677,LOMBARDIA,173
69,20200428,869,76546,LOMBARDIA,174
70,20200429,1049,77595,LOMBARDIA,175
71,20200430,1034,78629,LOMBARDIA,176
72,20200501,259,78888,LOMBARDIA,177
73,20200502,287,79175,LOMBARDIA,178
74,20200503,117,79292,LOMBARDIA,179
75,20200504,709,80001,LOMBARDIA,180
76,20200505,764,80765,LOMBARDIA,181
77,20200506,716,81481,LOMBARDIA,182
78,20200507,688,82169,LOMBARDIA,183
79,20200508,664,82833,LOMBARDIA,184
80,20200509,248,83081,LOMBARDIA,185
81,20200510,89,83170,LOMBARDIA,186
82,20200511,473,83643,LOMBARDIA,187
83,20200512,430,84073,LOMBARDIA,188
84,20200513,418,84491,LOMBARDIA,189
85,20200514,396,84887,LOMBARDIA,190
86,20200515,361,85248,LOMBARDIA,191
87,20200516,299,85547,LOMBARDIA,192
88,20200517,87,85634,LOMBARDIA,193
89,20200518,321,85955,LOMBARDIA,194
90,20200519,363,86318,LOMBARDIA,195
91,20200520,373,86691,LOMBARDIA,196
92,20200521,350,87041,LOMBARDIA,197
93,20200522,437,87478,LOMBARDIA,198
94,20200523,167,87645,LOMBARDIA,199
95,20200524,63,87708,LOMBARDIA,200
96,20200525,289,87997,LOMBARDIA,201
97,20200526,321,88318,LOMBARDIA,202
98,20200527,350,88668,LOMBARDIA,203
99,20200528,317,88985,LOMBARDIA,204
100,20200529,222,89207,LOMBARDIA,205
101,20200530,172,89379,LOMBARDIA,206
102,20200531,26,89405,LOMBARDIA,207
103,20200601,246,89651,LOMBARDIA,208
104,20200602,31,89682,LOMBARDIA,209
105,20200603,252,89934,LOMBARDIA,210
106,20200604,248,90182,LOMBARDIA,211
