OBJECTID,DATA_RICEVIMENTO_TAMPONE,NUM_TAMP,INCREMENTO,REGIONE,ObjectId2
1,20200220,3,3,LOMBARDIA,1
2,20200221,30,33,LOMBARDIA,2
3,20200222,32,65,LOMBARDIA,3
4,20200223,47,112,LOMBARDIA,4
5,20200224,60,172,LOMBARDIA,5
6,20200225,96,268,LOMBARDIA,6
7,20200226,117,385,LOMBARDIA,7
8,20200227,147,532,LOMBARDIA,8
9,20200228,204,736,LOMBARDIA,9
10,20200229,250,986,LOMBARDIA,10
11,20200301,284,1270,LOMBARDIA,11
12,20200302,398,1668,LOMBARDIA,12
13,20200303,477,2145,LOMBARDIA,13
14,20200304,630,2775,LOMBARDIA,14
15,20200305,793,3568,LOMBARDIA,15
16,20200306,905,4473,LOMBARDIA,16
17,20200307,701,5174,LOMBARDIA,17
18,20200308,772,5946,LOMBARDIA,18
19,20200309,1217,7163,LOMBARDIA,19
20,20200310,1354,8517,LOMBARDIA,20
21,20200311,1335,9852,LOMBARDIA,21
22,20200312,1362,11214,LOMBARDIA,22
23,20200313,1723,12937,LOMBARDIA,23
24,20200314,1375,14312,LOMBARDIA,24
25,20200315,1194,15506,LOMBARDIA,25
26,20200316,2135,17641,LOMBARDIA,26
27,20200317,2089,19730,LOMBARDIA,27
28,20200318,2162,21892,LOMBARDIA,28
29,20200319,2231,24123,LOMBARDIA,29
30,20200320,2226,26349,LOMBARDIA,30
31,20200321,1410,27759,LOMBARDIA,31
32,20200322,1163,28922,LOMBARDIA,32
33,20200323,2191,31113,LOMBARDIA,33
34,20200324,2159,33272,LOMBARDIA,34
35,20200325,2053,35325,LOMBARDIA,35
36,20200326,2056,37381,LOMBARDIA,36
37,20200327,1993,39374,LOMBARDIA,37
38,20200328,1364,40738,LOMBARDIA,38
39,20200329,758,41496,LOMBARDIA,39
40,20200330,1760,43256,LOMBARDIA,40
41,20200331,1542,44798,LOMBARDIA,41
42,20200401,1813,46611,LOMBARDIA,42
43,20200402,1625,48236,LOMBARDIA,43
44,20200403,1619,49855,LOMBARDIA,44
45,20200404,1081,50936,LOMBARDIA,45
46,20200405,640,51576,LOMBARDIA,46
47,20200406,1570,53146,LOMBARDIA,47
48,20200407,1490,54636,LOMBARDIA,48
49,20200408,1501,56137,LOMBARDIA,49
50,20200409,1929,58066,LOMBARDIA,50
51,20200410,2051,60117,LOMBARDIA,51
52,20200411,1136,61253,LOMBARDIA,52
53,20200412,553,61806,LOMBARDIA,53
54,20200413,568,62374,LOMBARDIA,54
55,20200414,1152,63526,LOMBARDIA,55
56,20200415,1382,64908,LOMBARDIA,56
57,20200416,1254,66162,LOMBARDIA,57
58,20200417,1308,67470,LOMBARDIA,58
59,20200418,757,68227,LOMBARDIA,59
60,20200419,392,68619,LOMBARDIA,60
61,20200420,1160,69779,LOMBARDIA,61
62,20200421,1074,70853,LOMBARDIA,62
63,20200422,968,71821,LOMBARDIA,63
64,20200423,1211,73032,LOMBARDIA,64
65,20200424,1025,74057,LOMBARDIA,65
66,20200425,496,74553,LOMBARDIA,66
133,20200701,125,94109,LOMBARDIA,67
134,20200702,130,94239,LOMBARDIA,68
135,20200703,108,94347,LOMBARDIA,69
136,20200704,102,94449,LOMBARDIA,70
137,20200705,22,94471,LOMBARDIA,71
138,20200706,130,94601,LOMBARDIA,72
139,20200707,94,94695,LOMBARDIA,73
140,20200708,120,94815,LOMBARDIA,74
141,20200709,100,94915,LOMBARDIA,75
142,20200710,106,95021,LOMBARDIA,76
143,20200711,59,95080,LOMBARDIA,77
144,20200712,11,95091,LOMBARDIA,78
145,20200713,63,95154,LOMBARDIA,79
146,20200714,78,95232,LOMBARDIA,80
147,20200715,77,95309,LOMBARDIA,81
148,20200716,66,95375,LOMBARDIA,82
149,20200717,85,95460,LOMBARDIA,83
150,20200718,49,95509,LOMBARDIA,84
151,20200719,15,95524,LOMBARDIA,85
152,20200720,72,95596,LOMBARDIA,86
153,20200721,69,95665,LOMBARDIA,87
154,20200722,61,95726,LOMBARDIA,88
155,20200723,91,95817,LOMBARDIA,89
156,20200724,85,95902,LOMBARDIA,90
157,20200725,40,95942,LOMBARDIA,91
158,20200726,15,95957,LOMBARDIA,92
159,20200727,80,96037,LOMBARDIA,93
160,20200728,68,96105,LOMBARDIA,94
161,20200729,84,96189,LOMBARDIA,95
162,20200730,51,96240,LOMBARDIA,96
163,20200731,61,96301,LOMBARDIA,97
164,20200801,34,96335,LOMBARDIA,98
165,20200802,17,96352,LOMBARDIA,99
166,20200803,170,96522,LOMBARDIA,100
167,20200804,76,96598,LOMBARDIA,101
168,20200805,83,96681,LOMBARDIA,102
169,20200806,84,96765,LOMBARDIA,103
170,20200807,79,96844,LOMBARDIA,104
171,20200808,59,96903,LOMBARDIA,105
172,20200809,20,96923,LOMBARDIA,106
173,20200810,99,97022,LOMBARDIA,107
174,20200811,96,97118,LOMBARDIA,108
175,20200812,94,97212,LOMBARDIA,109
176,20200813,97,97309,LOMBARDIA,110
177,20200814,104,97413,LOMBARDIA,111
178,20200815,18,97431,LOMBARDIA,112
179,20200816,19,97450,LOMBARDIA,113
180,20200817,147,97597,LOMBARDIA,114
181,20200818,150,97747,LOMBARDIA,115
182,20200819,169,97916,LOMBARDIA,116
183,20200820,207,98123,LOMBARDIA,117
184,20200821,274,98397,LOMBARDIA,118
185,20200822,146,98543,LOMBARDIA,119
186,20200823,52,98595,LOMBARDIA,120
187,20200824,331,98926,LOMBARDIA,121
188,20200825,340,99266,LOMBARDIA,122
189,20200826,291,99557,LOMBARDIA,123
190,20200827,338,99895,LOMBARDIA,124
191,20200828,241,100136,LOMBARDIA,125
192,20200829,142,100278,LOMBARDIA,126
193,20200830,79,100357,LOMBARDIA,127
194,20200831,244,100601,LOMBARDIA,128
195,20200901,128,100729,LOMBARDIA,129
196,20200902,53,100782,LOMBARDIA,130
67,20200426,228,74781,LOMBARDIA,131
68,20200427,927,75708,LOMBARDIA,132
69,20200428,871,76579,LOMBARDIA,133
70,20200429,1049,77628,LOMBARDIA,134
71,20200430,1034,78662,LOMBARDIA,135
72,20200501,261,78923,LOMBARDIA,136
73,20200502,287,79210,LOMBARDIA,137
74,20200503,115,79325,LOMBARDIA,138
75,20200504,709,80034,LOMBARDIA,139
76,20200505,764,80798,LOMBARDIA,140
77,20200506,717,81515,LOMBARDIA,141
78,20200507,688,82203,LOMBARDIA,142
79,20200508,665,82868,LOMBARDIA,143
80,20200509,249,83117,LOMBARDIA,144
81,20200510,89,83206,LOMBARDIA,145
82,20200511,475,83681,LOMBARDIA,146
83,20200512,430,84111,LOMBARDIA,147
84,20200513,418,84529,LOMBARDIA,148
85,20200514,398,84927,LOMBARDIA,149
86,20200515,361,85288,LOMBARDIA,150
87,20200516,299,85587,LOMBARDIA,151
88,20200517,87,85674,LOMBARDIA,152
89,20200518,321,85995,LOMBARDIA,153
90,20200519,363,86358,LOMBARDIA,154
91,20200520,374,86732,LOMBARDIA,155
92,20200521,348,87080,LOMBARDIA,156
93,20200522,437,87517,LOMBARDIA,157
94,20200523,167,87684,LOMBARDIA,158
95,20200524,64,87748,LOMBARDIA,159
96,20200525,289,88037,LOMBARDIA,160
97,20200526,321,88358,LOMBARDIA,161
98,20200527,351,88709,LOMBARDIA,162
99,20200528,318,89027,LOMBARDIA,163
100,20200529,223,89250,LOMBARDIA,164
101,20200530,172,89422,LOMBARDIA,165
102,20200531,26,89448,LOMBARDIA,166
103,20200601,246,89694,LOMBARDIA,167
104,20200602,31,89725,LOMBARDIA,168
105,20200603,252,89977,LOMBARDIA,169
106,20200604,248,90225,LOMBARDIA,170
107,20200605,255,90480,LOMBARDIA,171
108,20200606,120,90600,LOMBARDIA,172
109,20200607,35,90635,LOMBARDIA,173
110,20200608,173,90808,LOMBARDIA,174
111,20200609,248,91056,LOMBARDIA,175
112,20200610,241,91297,LOMBARDIA,176
113,20200611,324,91621,LOMBARDIA,177
114,20200612,280,91901,LOMBARDIA,178
115,20200613,124,92025,LOMBARDIA,179
116,20200614,40,92065,LOMBARDIA,180
117,20200615,196,92261,LOMBARDIA,181
118,20200616,169,92430,LOMBARDIA,182
119,20200617,204,92634,LOMBARDIA,183
120,20200618,137,92771,LOMBARDIA,184
121,20200619,188,92959,LOMBARDIA,185
122,20200620,60,93019,LOMBARDIA,186
123,20200621,12,93031,LOMBARDIA,187
124,20200622,170,93201,LOMBARDIA,188
125,20200623,149,93350,LOMBARDIA,189
126,20200624,117,93467,LOMBARDIA,190
127,20200625,101,93568,LOMBARDIA,191
128,20200626,107,93675,LOMBARDIA,192
129,20200627,45,93720,LOMBARDIA,193
130,20200628,29,93749,LOMBARDIA,194
131,20200629,136,93885,LOMBARDIA,195
132,20200630,99,93984,LOMBARDIA,196
